12,12
1,1,1,1,1,1,1,1,1,1,1,1
1,0,0,0,0,0,0,0,0,0,0,1
1,0,1,1,1,1,1,1,1,1,0,1
1,0,0,1,0,0,0,0,0,0,0,1
1,1,0,1,1,1,1,0,1,202,1,1
1,0,0,0,0,0,0,0,0,0,0,1
1,0,1,1,1,0,1,1,1,1,0,1
1,0,1,0,1,0,0,0,0,0,0,1
1,0,0,0,1,0,1,1,1,1,1,1
1,0,1,0,1,0,1,0,0,0,0,1
1,0,1,0,1,0,0,0,1,0,201,1
1,1,1,1,1,1,1,1,1,1,1,1