12,12
1,1,1,1,1,1,1,1,1,1,1,1
1,0,0,0,0,1,0,0,0,0,0,1
1,0,1,1,0,1,1,0,1,1,0,1
1,0,0,1,0,0,0,0,0,0,0,1
1,1,0,1,1,1,1,0,1,1,1,1
1,0,0,0,1,0,0,0,0,0,0,1
1,0,1,0,1,0,1,1,1,1,0,1
1,0,1,0,1,0,0,0,0,0,0,1
1,0,0,202,0,1,1,0,1,1,1,1
1,1,0,1,1,1,1,0,1,0,0,1
1,1,0,1,1,203,0,0,0,0,0,1
1,1,1,1,1,1,1,1,1,1,1,1